10 5

1 1 1 1 1 1 1 1 1 1 
1 1 1 1 1 1 1 1 1 1 
1 1 1 1 1 1 1 1 1 1 
1 1 1 1 1 1 1 1 1 1 
1 1 1 1 1 1 1 1 1 1 

10 10 10 10 10 10 10 10 10 10 
10 0 0 0 0 0 0 0 0 10 
10 0 0 0 0 0 0 0 0 10 
10 0 0 0 0 0 0 0 0 0 
10 10 10 10 10 10 10 10 10 10 

3 0 0 3 3 0 0 0 3 0 
0 0 0 0 0 0 0 0 0 3 
3 0 0 0 0 0 0 0 0 0 
3 6 1 0 0 0 0 0 0 0 
0 0 0 3 3 0 3 0 0 0 