30 20

1 1 1 1 1 1 1 1 1 1 1 1 1 1 1 1 1 1 1 1 1 1 1 1 1 1 1 1 1 1 
1 1 1 1 1 1 1 1 1 1 1 1 1 1 1 1 1 1 1 1 1 1 1 1 1 1 1 1 1 1 
1 1 1 1 1 1 1 1 1 1 1 1 1 1 1 1 1 1 1 1 1 1 1 1 1 1 1 1 1 1 
1 1 1 1 1 1 1 1 1 1 1 1 1 1 1 1 1 1 1 1 1 1 1 1 1 1 1 1 1 1 
1 1 1 1 1 1 1 1 1 1 1 1 1 1 1 1 1 1 1 1 1 1 1 1 1 1 1 1 1 1 
1 1 1 1 1 1 1 1 1 1 1 1 1 1 1 1 1 1 1 1 1 1 1 1 1 1 1 1 1 1 
1 1 1 1 1 1 1 1 1 1 1 1 1 1 1 1 1 1 1 1 1 1 1 1 1 1 1 1 1 1 
1 1 1 1 1 1 1 1 1 1 1 1 1 1 1 1 1 1 1 1 1 1 1 1 1 1 1 1 1 1 
1 1 1 1 1 1 1 1 1 1 1 1 1 1 1 1 1 1 1 1 1 1 1 1 1 1 1 1 1 1 
1 1 1 1 1 1 1 1 1 1 1 1 1 1 1 1 1 1 1 1 1 1 1 1 1 1 1 1 1 1 
1 1 1 1 1 1 1 1 1 1 1 1 1 1 1 1 1 1 1 1 1 1 1 1 1 1 1 1 1 1 
1 1 1 1 1 1 1 1 1 1 1 1 1 1 1 1 1 1 1 1 1 1 1 1 1 1 1 1 1 1 
1 1 1 1 1 1 1 1 1 1 1 1 1 1 1 1 1 1 1 1 1 1 1 1 1 1 1 1 1 1 
1 1 1 1 1 1 1 1 1 1 1 1 1 1 1 1 1 1 1 1 1 1 1 1 1 1 1 1 1 1 
1 1 1 1 1 1 1 1 1 1 1 1 1 1 1 1 1 1 1 1 1 1 1 1 1 1 1 1 1 1 
1 1 1 1 1 1 1 1 1 1 1 1 1 1 1 1 1 1 1 1 1 1 1 1 1 1 1 1 1 1 
1 1 1 1 1 1 1 1 1 1 1 1 1 1 1 1 1 1 1 1 1 1 1 1 1 1 1 1 1 1 
1 1 1 1 1 1 1 1 1 1 1 1 1 1 1 1 1 1 1 1 1 1 1 1 1 1 1 1 1 1 
1 1 1 1 1 1 1 1 1 1 1 1 1 1 1 1 1 1 1 1 1 1 1 1 1 1 1 1 1 1 
1 1 1 1 1 1 1 1 1 1 1 1 1 1 1 1 1 1 1 1 1 1 1 1 1 1 1 1 1 1 

10 10 10 10 10 10 10 10 10 10 10 10 10 10 10 10 10 10 10 10 10 10 10 10 10 10 10 10 10 10 
10 0 0 0 0 0 0 0 0 0 0 0 0 0 0 0 0 0 0 0 10 10 10 10 10 10 0 0 0 10 
10 0 0 0 0 0 0 0 0 0 0 0 0 0 0 0 0 0 0 0 0 10 10 10 10 0 0 0 0 10 
10 0 0 0 0 0 0 0 0 0 0 0 0 10 10 10 10 10 10 0 0 0 10 10 10 0 0 0 0 10 
10 0 0 0 0 0 0 0 0 10 0 0 0 10 10 10 10 10 10 0 0 0 10 10 0 0 0 0 0 10 
10 0 0 0 0 0 0 0 0 10 0 0 0 10 10 10 10 10 10 0 0 0 10 10 0 0 0 0 10 10 
10 0 0 0 0 0 0 0 0 10 0 0 0 10 10 10 10 10 10 10 0 0 0 10 0 0 0 0 0 10 
10 0 0 0 0 0 0 0 0 0 0 0 10 10 10 10 10 10 10 10 0 0 0 10 10 0 0 0 0 10 
10 0 0 0 0 10 10 0 0 0 0 0 10 10 10 10 10 10 10 10 0 0 0 0 0 0 0 0 10 10 
10 10 0 0 0 0 0 10 0 0 0 0 10 10 10 10 10 10 10 10 10 0 0 0 0 0 0 10 10 10 
10 10 0 0 0 0 0 0 0 0 0 10 10 10 10 10 10 10 10 10 10 0 0 0 0 0 0 10 10 10 
10 10 10 0 0 0 0 0 0 0 0 10 10 10 10 10 10 10 10 10 10 0 0 0 0 0 10 10 10 10 
10 10 10 0 0 0 10 10 0 0 0 10 10 10 10 10 10 10 10 10 10 0 0 0 0 0 10 10 10 10 
10 10 10 10 0 0 0 0 0 0 0 10 10 10 10 10 10 10 10 10 10 10 0 0 0 0 10 10 10 10 
10 10 10 10 0 0 0 0 0 0 0 10 10 10 10 10 10 10 10 10 10 10 10 0 0 0 10 10 10 10 
10 10 10 10 0 0 0 10 0 0 10 10 10 10 10 10 10 10 10 10 10 10 10 0 0 0 10 10 10 10 
10 10 10 10 0 0 0 0 0 0 10 10 10 10 10 10 10 10 10 10 10 10 10 0 0 0 10 10 10 10 
10 10 10 10 10 0 0 0 0 0 10 10 10 10 10 10 10 10 10 10 10 10 10 0 0 0 10 10 10 10 
10 10 10 10 10 0 0 0 0 0 10 10 10 10 10 10 10 10 10 10 10 10 10 10 10 10 10 10 10 10 
10 10 10 10 10 10 10 10 10 10 10 10 10 10 10 10 10 10 10 10 10 10 10 10 10 10 10 10 10 10 

0 3 0 3 0 3 0 0 0 0 0 0 0 0 0 0 0 0 0 0 0 0 0 0 0 0 0 0 0 0 
0 0 0 0 0 0 0 0 0 0 0 0 0 0 0 0 0 0 0 0 0 0 0 0 0 3 0 0 0 0 
3 0 0 0 0 0 0 0 2 0 0 4 0 0 0 1 0 0 0 0 0 0 0 0 3 0 0 0 0 0 
3 0 0 4 0 0 0 0 0 0 0 0 0 0 3 3 0 0 0 0 0 0 3 3 0 0 0 4 0 0 
0 0 0 0 0 0 0 0 0 3 0 0 0 3 0 0 0 3 3 0 2 0 0 0 0 0 0 0 0 0 
0 0 0 0 0 4 0 0 0 3 0 0 0 0 0 0 0 3 0 0 0 0 0 3 0 0 0 0 3 3 
3 0 0 0 0 0 0 0 0 0 0 0 1 3 0 0 0 0 3 0 0 0 0 3 1 0 0 0 0 0 
0 0 0 0 0 0 1 0 0 0 0 0 0 3 0 0 0 0 0 0 0 0 0 0 3 0 0 0 1 0 
0 0 0 0 0 0 3 0 0 0 2 0 3 0 0 0 0 0 0 3 0 0 0 0 0 0 0 0 0 0 
0 3 0 0 0 0 0 3 0 0 0 0 0 0 0 0 0 0 0 0 3 0 0 0 0 0 0 0 3 0 
0 0 0 0 2 0 0 0 0 0 0 0 3 0 0 0 0 0 0 3 0 0 0 4 0 0 0 0 0 3 
0 0 3 0 0 0 0 0 0 0 0 0 0 0 0 0 0 0 0 0 0 0 0 0 0 0 0 3 0 0 
0 0 3 0 0 0 3 0 0 0 0 3 0 0 3 0 0 0 0 0 3 1 0 0 2 0 3 0 0 0 
0 0 0 0 0 0 0 0 0 0 0 0 0 0 0 0 0 0 0 0 0 3 0 0 0 0 0 0 0 0 
0 0 0 3 0 0 0 0 0 0 0 0 3 0 0 0 0 0 0 0 3 0 3 0 0 0 0 3 0 0 
0 0 0 3 0 0 0 0 0 0 0 0 0 0 0 0 0 0 0 0 0 3 3 0 0 0 0 0 3 3 
0 0 0 0 0 2 0 0 0 0 3 0 0 0 0 0 0 0 0 0 0 0 3 0 0 0 0 3 0 0 
0 0 0 3 0 0 0 0 0 0 3 0 0 0 0 0 0 0 0 0 0 0 3 0 1 0 0 3 0 0 
0 0 0 0 3 0 1 6 0 0 0 0 0 0 0 0 0 0 0 0 0 0 0 3 0 3 3 0 0 0 
0 0 0 0 3 0 3 0 3 0 3 0 0 0 0 0 0 0 0 0 0 0 0 0 3 0 0 0 0 0 